IIJJJJXXXXX
ICCCCXXXXXX
IIBBCXXXXXX
ABBBDXXXXXX
AAADDDDXXXX